barcode	donor_id
ACACCAAAGGTGATTA	donor0
ACAGCTAAGACATAAC	donor4
ACGTCAAAGTGTACGG	donor3
AGAATAGTCATGTGGT	donor4
AGCCTAACACCATGTA	donor0
AGTGTCAGTACAGTTC	donor0
AGTTGGTGTGGTGTAG	donor4
ATCACGACAGCTGTTA	donor0
ATCGAGTCATATACCG	donor4
ATCGAGTTCCCGGATG	donor1
CAACTAGTCATCTGCC	donor0
CAAGGCCTCGCTTAGA	donor3
CAAGTTGCACAGATTC	donor2
CAGCGACCATGAGCGA	donor3
CATCCACAGGGCATGT	donor4
CATTCGCCAGCTGTAT	donor0
CCAGCGAAGAACTCGG	donor4
CCATTCGGTACTTAGC	donor3
CCGTTCATCCATTCTA	donor3
CGGAGCTTCAGTCCCT	donor0
CTCTACGCATGCAATC	donor4
CTGCCTAGTACGCACC	donor0
CTTCTCTCACTGTGTA	donor3
GACTAACAGGATGTAT	donor0
GAGTCCGCAGTTCATG	donor0
GATCAGTTCTTAGAGC	donor0
GATGAAATCTGACCTC	donor0
GCATGCGTCACTTACT	donor1
GCATGTATCTGGAGCC	donor0
GCGGGTTAGCCCAGCT	donor0
GGCTCGACACCGGAAA	donor4
GGGAATGCAAAGCGGT	donor3
GGGATGATCCTTTCGG	donor3
GGGTTGCTCACATAGC	donor3
GTAACGTTCATCTGTT	donor3
GTCAAGTGTTCCATGA	donor1
GTCACAATCCAGTATG	donor0
GTGAAGGAGTCTTGCA	donor4
GTGCGGTAGTGTTGAA	donor3
TAAGAGATCCCTGACT	donor0
TATCAGGTCGTAGATC	donor0
TATCTCAAGCCTTGAT	donor0
TCAGCAATCGTTACAG	donor3
TCAGGATTCCTAGTGA	donor3
TCATTACCATTCCTGC	donor1
TCGTAGAAGTCTCCTC	donor1
TCTGGAATCGCAGGCT	donor0
TGACTTTCAATTCCTT	donor1
TGAGAGGCACCTCGTT	donor0
TGCTACCTCCTTGCCA	donor3
TTAACTCTCTTTACGT	donor3
TTCGAAGGTATAATGG	donor0
TTGACTTGTTCCAACA	donor0
TTGGAACAGTTAGCGG	donor4
TTGGCAATCGTTGACA	donor3
TTTACTGCAATGCCAT	donor3
